# if next token is not a comment

START -> FUN START' | GLOBAL-STATEMENT START

START' -> START | ^

FUN -> func TYPE ID COLON BODY

BODY -> begin C-STATEMENTS BODY'

BODY' -> end | return VALUE end

VALUE -> ID | NUMERIC | STRING | ^

C-STATEMETNS -> STATEMENTS C-STATEMETNS'| LOOP | SELECTION

C-STATEMETNS' -> C-STATEMETNS | ^

LOOP -> for ASSIGNMENT COMMA BOOL COMMA ASSIGNMENT COLON BODY | while BOOL: BODY

SELECTION -> if BOOL COLON BODY

BOOL -> VALUE REL-OP VALUE BOOL'| TRUE BOOL' | FALSE BOOL' | NUMERIC-BOOL BOOL'

BOOL' -> LOGICAL-OP BOOL BOOL'| ^


NUMERIC-BOOL -> DIGIT C'

C' -> NUMERIC-BOOL | ^

LOGICAL-OP -> && | || | & | '|' | !

VALUE -> ID | NUMERIC

GLOBAL-STATEMENT -> DEC-STATEMENT; | ASSIGNMENT; | DEC-AS; | ^ 

STATEMENTS -> IO-STATEMENT; STATEMENTS | DEC-STATEMENT; STATEMENTS | ASSIGNMENT; STATEMENTS | DEC-AS; STATEMENTS | ^ 

IO-STATEMENT -> in ID; | print PRINTABLE

PRINTABLE -> STRING; | ID; | EXPRESSION;

DEC-STATEMENT -> ID TYPE

ASSIGNMENT -> ID REMAINING | ++ID | --ID

REMAINING -> AS-OP | ++ | --

REMAINING' -> STRING | EXPRESSION

EXPRESSION -> EXPRESSION' A'

A' -> + EXPRESSION' A' | - EXPRESSION' A' | ^

EXPRESSION -> EXPRESSION' B'

B' -> * EXPRESSION' B' | / EXPRESSION' B' | ^

EXPRESSION'' -> ID | NUMERIC

AS-OP -> = | <-

REL-OP -> < | > | <= | >= | == 

STRING -> DOUBLE-QUOTE CHARS DOUBLE-QUOTE

DOUBLE-QUOTE -> "

CHARS -> CHAR CHARS | ^

CHAR ->   ALPHABETS | NUMERIC | !|@|#|$|%|^|&|*|(|)|_|+|=|~| SPACES

ALPHABETS -> SMALL-LETTER ALPHABETS | CAPITAL-LETTER ALPHABETS

SMALL-LETTER -> a|b|c|d|e|f|g|h|i|j|k|l|m|n|o|p|q|r|s|t|u|v|w|x|y|z

CAPITAL-LETTER -> A|B|C|D|E|F|G|H|I|J|K|L|M|N|O|P|Q|R|S|T|U|V|W|X|Y|Z

SPACES -> SINGLE-SPACE SPACES

SINGLE-SPACE -> ' '

NUMERIC -> DIGIT NUMERIC | NUMERIC.NUMERIC | DIGIT

NUMERIC -> DIGIT OTHER-DIGIT

OTHER-DIGIT -> NUMERIC NUMERIC' | NUMERIC'   

NUMERIC' -> .NUMERIC NUMERIC'|^

DIGIT -> 0|1|2|3|4|5|6|7|8|9

ID -> ALPHABETS ALPHABETS' | UNDERSCORE ALPHABETS NUMERIC''

NUMERIC'' -> NUMERIC | ^

ALPHABETS' -> NUMERIC | ^

COLON -> :

COMMA -> ,

UNDERSCORE -> _
